Resume Quest
An Interactive Fiction
Release 1 / Serial number 140607 / Inform 7 build 6G60 (I6/v6.32 lib 6/12N) SD

Office
You are in a dimly lit office.  There is a dark room to the east, and a small room to the south. In the back of the room there is a large metal desk.

On the desk is an old computer.

>get computer
They don't make \"em like this anymore. You wouldn't want to damage it.

* * *

Resume Quest
An Interactive Fiction
Release 1 / Serial number 140607 / Inform 7 build 6G60 (I6/v6.32 lib 6/12N) SD

Office
You are in a dimly lit office.  There is a dark room to the east, and a small room to the south. In the back of the room there is a large metal desk.

On the desk is an old computer.

>use computer
That's not a verb I recognise.

>boot computer
The old computer chimes cheerfully.

The old computer's screen is displaying a generic system error.

>look computer
Which do you mean, the old computer, the old computer's mouse, the old computer's screen, the old computer's keyboard or the old computer's software?

>look old computer
Which do you mean, the old computer, the old computer's mouse, the old computer's screen, the old computer's keyboard or the old computer's software?

>look old computer screen
The old computer's screen is displaying a generic system error.

>look at old computer
Which do you mean, the old computer, the old computer's mouse, the old computer's screen, the old computer's keyboard or the old computer's software?

>look at the old computer
Which do you mean, the old computer, the old computer's mouse, the old computer's screen, the old computer's keyboard or the old computer's software?

>old computer
Which do you mean, the old computer, the old computer's mouse, the old computer's screen, the old computer's keyboard or the old computer's software?

>old computer's mouse
Just the ordinary wired variety.

>the old computer!
That's not a verb I recognise.

>look at the old computer
Which do you mean, the old computer, the old computer's mouse, the old computer's screen, the old computer's keyboard or the old computer's software?

>look at the old computer
Which do you mean, the old computer, the old computer's mouse, the old computer's screen, the old computer's keyboard or the old computer's software?

>look at the old computer's mouse
Just the ordinary wired variety.

>look at the old computer's screen
The old computer's screen is displaying a generic system error.

>look at computer
Which do you mean, the old computer, the old computer's mouse, the old computer's screen, the old computer's keyboard or the old computer's software?

>get old computer
(the old computer)
They don't make them like this anymore. You wouldn't want to damage it.

>look at (the old computer)
You can't see any such thing.

>examine the old computer
Which do you mean, the old computer, the old computer's mouse, the old computer's screen, the old computer's keyboard or the old computer's software?

* * *

>boot computer
The old computer chimes cheerfully.

The old computer's screen is displaying a generic system error.

>look screen
The old computer's screen is displaying a generic system error.

* * *

Resume Quest
An Interactive Fiction
Release 1 / Serial number 140607 / Inform 7 build 6G60 (I6/v6.32 lib 6/12N) SD

Office
You are in a dimly lit office.  There is a dark room to the east, and a small room to the south. In the back of the room there is a large metal desk.

On the desk is an old computer.

>look screen
 The screen is dark.

>look computer screen
 The screen is dark.

>boot computer
The old computer chimes cheerfully.

The old computer's screen is displaying a generic system error.

* * *

>look screen
The old computer's screen is displaying a generic system error.

>look screen
The old computer's screen is displaying a generic system error.

* * *

>look screen
 The screen is dark.

>boot computer
The old computer chimes cheerfully.

The old computer's screen is displaying a generic system error.

* * *

Resume Quest
An Interactive Fiction
Release 1 / Serial number 140607 / Inform 7 build 6G60 (I6/v6.32 lib 6/12N) SD

Office
You are in a dimly lit office.  There is a dark room to the east, and a small room to the south. In the back of the room there is a large metal desk.

On the desk is an old computer.

>look at computer
Which do you mean, the old computer, the old computer's mouse, the old computer's screen, the old computer's keyboard or the old computer's software?

>examine old computer computer
Which do you mean, the old computer, the old computer's mouse, the old computer's screen, the old computer's keyboard or the old computer's software?

* * *

Resume Quest
An Interactive Fiction
Release 1 / Serial number 140607 / Inform 7 build 6G60 (I6/v6.32 lib 6/12N) SD

Office
You are in a dimly lit office.  There is a dark room to the east, and a small room to the south. In the back of the room there is a large metal desk.

On the desk is an old computer.

>They don't make 'em like this anymore
That's not a verb I recognise.

>get computer
They don't make "em like this anymore. You wouldn't want to damage it.

* * *

Resume Quest
An Interactive Fiction
Release 1 / Serial number 140607 / Inform 7 build 6G60 (I6/v6.32 lib 6/12N) SD

Office
You are in a dimly lit office.  There is a dark room to the east, and a small room to the south. In the back of the room there is a large metal desk.

On the desk is an old computer.

>look computer
Which do you mean, the old computer, the old computer's mouse, the old computer's screen, the old computer's keyboard or the old computer's software?

>look computer screen
 The screen is dark.

* * *

Resume Quest
An Interactive Fiction
Release 1 / Serial number 140607 / Inform 7 build 6G60 (I6/v6.32 lib 6/12N) SD

Office
You are in a dimly lit office.  There is a dark room to the east, and a small room to the south. In the back of the room there is a large metal desk.

On the desk is an old computer.

>ex computer
That's not a verb I recognise.

>look computer
Which do you mean, the old computer, the old computer's mouse, the old computer's screen, the old computer's keyboard or the old computer's software?

>look old computer's mouse
Just the ordinary wired variety.

>look computer's screen
The old computer's screen is currently blank.

>boot computer
The old computer chimes cheerfully.

The old computer's screen is displaying a generic system error.

* * *

Resume Quest
An Interactive Fiction
Release 1 / Serial number 140607 / Inform 7 build 6G60 (I6/v6.32 lib 6/12N) SD

Office
You are in a dimly lit office.  There is a dark room to the east, and a small room to the south. In the back of the room there is a large metal desk.

On the desk is an old computer.

>boot computer
The computer needs a floppy disk.

>1
That's not a verb I recognise.

>type 1
This is about Doug

>type 2
This is Doug's work history.

>type 3
This is Doug's education.

>e
Dark Room
It is very dark. You are likely to be eaten by a grue.

>w
Office
You are in a dimly lit office.  There is a dark room to the east, and a small room to the south. In the back of the room there is a large metal desk.

On the desk is an old computer.

* * *

>boot computer
The computer needs a floppy disk.

>s
Storage Room
You are in a small, cluttered room.

There is a black metal filing cabinet buried under a mountain of papers.

>open drawer
You open the drawer, revealing a floppy disk.

>get disk
Taken.

>n
Office
You are in a dimly lit office.  There is a dark room to the east, and a small room to the south. In the back of the room there is a large metal desk.

On the desk is an old computer.

>load disk into drive
That's not a verb I recognise.

>load floppy disk
That's not a verb I recognise.

>put floppy disk into disk drive
You put the floppy disk into the disk drive.

>boot computer
The old computer chimes cheerfully.

The following options are visible on the screen:

1: Profile
2: Work History
3: Education

>1
That's not a verb I recognise.

* * *

Resume Quest
An Interactive Fiction
Release 1 / Serial number 140607 / Inform 7 build 6G60 (I6/v6.32 lib 6/12N) SD

Office
You are in a dimly lit office.  There is a dark room to the east, and a small room to the south. In the back of the room there is a large metal desk.

On the desk is an old computer.

>s
Storage Room
You are in a small, cluttered room.

There is a black metal filing cabinet buried under a mountain of papers.

* * *

>n
Office
You are in a dimly lit office.  There is a dark room to the east, and a small room to the south. In the back of the room there is a large metal desk.

On the desk is an old computer.

>use disk in computer
That's not a verb I recognise.

>put disk in computer
(the floppy disk in the old computer)
You put the floppy disk into the disk drive.

>turn on computer
The old computer chimes cheerfully.

The following options are visible on the screen:

1: Profile
2: Work History
3: Education

>type 2
Since 2009, Doug has worked at Sport Ngin in Minneapolis, where he is a Senior Engineer. He has been heavily involved with many of their products, especially those that are sports-related.  Those projects include:

Sitebuilder, the company's flagship product, a CMS with integrated tools for sports organizations.  Built on Rails and MySQL, Doug contributed to numerous features, both front- and back-end.

Stat Ngin, a service for storing and serving the platform's sports and stats related data.  Doug was responsible for building, architecting, and migrating data to this API which serves millions of requests per day. It is a Rails-based application, backed by MongoDB.

Sport Ngin Live, which is a subset of Stat Ngin along iwth Javascript client apps, allows users to record and publish game data in real time.  Doug developed an elegant Ruby DSL which allows users to easily configure the events and stats for any sport. He also worked in a product design capacity to develop the workflow of the client applications.

Tournament, a tournament-management application.  This manages the complex rules and data needed to manage tournament events.

In addition to coding work, Doug started Lightning Club at Sport Ngin, which is an informal gathering of developers to give short talks, followed by critiques, to help developers improve their public speaking skills.

* * *

>n
Office
You are in a dimly lit office.  There is a dark room to the east, and a small room to the south. In the back of the room there is a large metal desk.

On the desk is an old computer.

>put disk in computer
(the floppy disk in the old computer)
You put the floppy disk into the disk drive.

* * *

>turn on computer
The old computer chimes cheerfully.

The following options are visible on the screen:

1: Profile
2: Work History
3: Education

>type 2
Since 2009, Doug has worked at Sport Ngin in Minneapolis, where he is a Senior Engineer. He has been heavily involved with many of their products, especially those that are sports-related.  Those projects include:

Sitebuilder, the company's flagship product, a CMS with integrated tools for sports organizations.  Built on Rails and MySQL, Doug contributed to numerous features, both front- and back-end.

Stat Ngin, a service for storing and serving the platform's sports and stats related data.  Doug was responsible for building, architecting, and migrating data to this API which serves millions of requests per day. It is a Rails-based application, backed by MongoDB.

Sport Ngin Live, which is a subset of Stat Ngin along with Javascript client apps, allows users to record and publish game data in real time.  Doug developed an elegant Ruby DSL which allows users to easily configure the events and stats for any sport. He also worked in a product design capacity to develop the workflow of the client applications.

Tournament, a tournament-management application.  This manages the complex rules and data needed to manage tournament events.

In addition to coding work, Doug started Lightning Club at Sport Ngin, which is an informal gathering of developers to give short talks, followed by critiques, to help developers improve their public speaking skills.

Prior to working a Sport Ngin, Doug spent over 3 years at Ratchet, a client development firm in Minneapolis.  At Ratchet, Doug worked mostly in C# and ASP.Net on a variety of projects, including: 
Explore Minnesota Tourism (C#, ASP.Net)  
Tablespoon.com (C#, ASP.Net, jQuery, Endeca);
Leaguesafe (C#, ASP.Net);
a catalog management application (VB.Net, ASP.Net);
a construction job estimation tool (C#, ASP.Net);various Regis websites (Coldfusion)

Before Ratchet, Doug worked at:

Best Buy (contract) - Analysis of direct marketing campaigns (SAS)
Prudential - Analysis of life insurance retention call center data (SAS, SQL Server, Excel); Internal tool and application development (MS Access, VB.Net)

Federal Reserve Board of Governors, Washington, DC - Research assistant supporting economists" work studying research on small business finances (SAS, Stata, Unix)

* * *

>turn on computer
The old computer chimes cheerfully.

The following options are visible on the screen:

1: Profile
2: Work History
3: Education

>press 2
You can't see any such thing.

>type 2
Since 2009, Doug has worked at Sport Ngin in Minneapolis, where he is a Senior Engineer. He has been heavily involved with many of their products, especially those that are sports-related.  Those projects include:
Sitebuilder, the company's flagship product, a CMS with integrated tools for sports organizations.  Built on Rails and MySQL, Doug contributed to numerous features, both front- and back-end.
Stat Ngin, a service for storing and serving the platform's sports and stats related data.  Doug was responsible for building, architecting, and migrating data to this API which serves millions of requests per day. It is a Rails-based application, backed by MongoDB.
Sport Ngin Live, which is a subset of Stat Ngin along iwth Javascript client apps, allows users to record and publish game data in real time.  Doug developed an elegant Ruby DSL which allows users to easily configure the events and stats for any sport. He also worked in a product design capacity to develop the workflow of the client applications.
Tournament, a tournament-management application.  This manages the complex rules and data needed to manage tournament events.
In addition to coding work, Doug started Lightning Club at Sport Ngin, which is an informal gathering of developers to give short talks, followed by critiques, to help developers improve their public speaking skills.

* * *

>s
Storage Room
You are in a small, cluttered room.

There is a black metal filing cabinet buried under a mountain of papers.

>n
Office
You are in a dimly lit office.  There is a dark room to the east, and a small room to the south. In the back of the room there is a large metal desk.

On the desk is a computer.

>get computer
They don't make them like this anymore. You wouldn't want to damage it.

* * *

Resume Quest
An Interactive Fiction
Release 1 / Serial number 140607 / Inform 7 build 6G60 (I6/v6.32 lib 6/12N) SD

Office
You are in a dimly lit office.  There is a dark room to the east, and a small room to the south. In the back of the room there is a large metal desk.

On the desk is an old computer.

>Look
Office
You are in a dimly lit office.  There is a dark room to the east, and a small room to the south. In the back of the room there is a large metal desk.

On the desk is an old computer.

>Use computer
That's not a verb I recognise.

>Boot computer
The computer needs a floppy disk.

>Insert floppy disk
I didn't understand that sentence.

>Find a floppy disk
That's not a verb I recognise.

>Insert disk into hard drive
You can't see any such thing.

>Look in the desk to find a floppy disk
I only understood you as far as wanting to look in the desk.

>Look in the small room to find a floppy disk
You can't see any such thing.

>Look in the dark room to find a floppy disk
You can't see any such thing.

>Open the desk to find a floppy disk
You can't see any such thing.

>Look in the filing cabinet
You can't see any such thing.

>Look in the filing cabinet for a floppy disk
You can't see any such thing.

>grab the floppy disk from the desk
That's not a verb I recognise.

>S
Storage Room
You are in a small, cluttered room.

There is a black metal filing cabinet buried under a mountain of papers.

>Open file cabinet
You can't see any such thing.

>Look cabinet
It is a black metal filing cabinet with one drawer slightly ajar.

In the filing cabinet is the drawer.

>Open drawer
You open the drawer, revealing a floppy disk.

>grab disk
That's not a verb I recognise.

>Take Disk
Taken.

>Insert disk in computer
You can't see any such thing.

>Go back into room
You can't see any such thing.

>Disk in computer
That's not a verb I recognise.

>Take disk to computer
I only understood you as far as wanting to take the floppy disk.

>N
Office
You are in a dimly lit office.  There is a dark room to the east, and a small room to the south. In the back of the room there is a large metal desk.

On the desk is an old computer.

>Insert floppy disk
I didn't understand that sentence.

>Go to desk
You can't see any such thing.

>Insert disk
I didn't understand that sentence.

>Put disk into disk drive
(the floppy disk into the disk drive)
You put the floppy disk into the disk drive.

>start program
That's not a verb I recognise.

>Open program
You can't see any such thing.

>Boot disk
Which do you mean, the disk drive or the floppy disk?

>floppy disk
That's not something you can switch.

>Boot floppy disk
That's not something you can switch.

>Boot disk drive
That's not something you can switch.

>turn on disk drive
That's not something you can switch.

>upload floppy disk
That's not a verb I recognise.

>open program on floppy disk
You can't see any such thing.

>boot computer
The old computer chimes cheerfully.

The following options are visible on the screen:

1: Profile
2: Work History
3: Education

* * *

>1
That's not a verb I recognise.

>1
That's not a verb I recognise.

>view profile
That's not a verb I recognise.

>View Profile
That's not a verb I recognise.

>View option 1
That's not a verb I recognise.

>type 1
This is about Doug

I beg your pardon?

>Tell me about Doug
You talk to yourself a while.

>Type 2
This is Doug's work history.

>Where did Doug work?
That's not a verb I recognise.

>Type 3
This is Doug's education.